Gg, Gg, Gg, Gg, Rr, Rr, Mm, Mm, Mm, Mm, Mm, Mm, Mm, Gg, Gg, Aa, Aa, Aa, Aa, Aa, Aa, Aa, Gg, Gg, Gg, Gg, Aa, Aa, Ha, Hh, Hh, Gs^Fp, Gs^Fp, Gg, Gg, Gg, Gg, Gg, Gg, Gg, Gg, Gg
Gg, Gg, Gg, Gg, Rr, Hh, Mm, Mm, Mm, Mm, Mm, Mm, Hh, Gg, Gg, Gg, Gg, Gg, Gg, Aa, Aa, Aa, Aa, Aa, Aa, Aa, Aa, Aa, Ha, Mm, Mm, Hh, Hh, Gs^Fp, Gg, Gg, Gg, Gg, Gg, Gg, Gg, Gg
Gg, Aa, Gg, Gg, Rr, Gg, Mm, Mm, Mm, Mm, Mm, Hh, Gg, Gg^Vh, Gg, Gg, Gg, Gg, Gg, Gg, Aa, Aa, Aa, Aa, Aa, Aa, Aa, Aa, Hh, Mm, Mm, Mm, Hh, Gg, Gg, Gg, Gg, Gg, Gg, Gg, Gg, Gg
Gg, Aa, Gg, Gs^Fp, Gg, Rr, Hh, Hh, Mm, Mm, Ha, Aa, Aa, Gg, Gg, Gg, Gg, Ds, Gg, Gg, Gg, Aa, Aa, Aa, Aa, Aa, Gg, Gg, Hh, Mm, Mm, Mm, Hh, Gg^Vh, Gg, Ch, Ch, Ch, Gg, Gg, Gg, Gs^Fp
Aa, Gg, Gg, Gs^Fp, Gs^Fp, Rr, Rr, Gg, Aa, Ha, Aa, Aa, Aa, Gg, Gg, Gg, Gg, Gg, Gg, Gg^Vh, Gg, Gg, Gg, Gg, Aa, Aa, Gg, Gg, Hh, Hh, Hh, Hh, Rr, Rr, Rr, Ch, 1 Kh, Ch, Gg, Gg, Gg, Gs^Fp
Aa, Gg, Gs^Fp, Gs^Fp, Gg, Gs^Fp, Rr, Gg^Vh, Aa, Aa, Aa, Aa, Gg, Gg, Gg, Gg, Gg, Gg, Gg, Gg, Gg, Gg, Ds, Ds, Aa, Aa, Gg, Gg, Gg, Gg, Rr, Rr, Aa, Gg, Ch, Ch, Ch, Gg, Gg, Gg, Gg, Gs^Fp
Gg, Gg, Gs^Fp, Gg, Gg, Gs^Fp, Rr, Gg, Aa, Aa, Gg, Gg, Gg, Gg, Gg, Gg, Gg, Gg, Gg, Ds, Ds, Ds, Ds, Ds, Aa, Gg, Gg, Gg, Gg^Vh, Gg, Rr, Aa, Aa, Gg, Gg, Gs^Fp, Gg, Gg, Gg, Gg, Gg, Gs^Fp
Gg, Gg, Gg^Ve, Gg, Gg, Gg, Rr, Gg, Aa, Aa, Gg, Gg, Gg, Aa, Gg, Gg, Gg, Gg, Gs^Fp, Ds, Ds, Ds, Ds, Gg, Aa, Aa, Rr, Rr, Rr, Rr, Gg, Gg, Gg, Gg, Gs^Fp, Gs^Fp, Gg, Gg^Vh, Gg, Gg, Gg, Gg
Gs^Fp, Gs^Fp, Gs^Fp, Gs^Fp, Gs^Fp, Rr, Gg, Gg, Aa, Aa, Gg, Gg, Gg, Gg, Gg^Vh, Gg, Gg, Gs^Fp, Gs^Fp, Ds, Ds, Ds, Ds, Gg, Rr, Aa, Rr, Aa, Gg, Gg, Gg, Gg, Gg, Gg, Gs^Fp, Gs^Fp, Gg, Gg, Gg, Gg, Gg, Gg
Gs^Fp, Gs^Fp, Gs^Fp, Gs^Fp, Gs^Fp, Rr, Rr, Gg, Aa, Gg, Gg, Gg, Gg, Gg, Gg, Gg, Gg, Gg, Gg, Gg, Ds, Ds, Gg, Rr, Aa, Rr, Gg, Aa, Hh, Mm, Hh, Gg, Gg, Gg, Gg, Gg, Gg, Gg, Gg, Gg, Gg, Hh
Gs^Fp, Gs^Fp, Gs^Fp, Gg, Gs^Fp, Gs^Fp, Gg, Rr, Gg, Gg, Gg, Gg, Gg, Gg, Gg, Gg, Gg, Gg, Gg, Ds, Ds, Gg, Gg, Aa, Aa, Aa, Hh, Mm, Mm, Mm, Mm, Hh, Gg^Vh, Gg, Gg, Gg, Gg, Gg, Gg, Gg, Gg, Hh
Gg, Gs^Fp, Gs^Fp, Gs^Fp, Gs^Fp, Gs^Fp, Gs^Fp, Rr, Rr, Gg, Gg, Gg, Aa, Aa, Gg, Gg, Gg, Gg, Gg, Ds, Ds, Gg, Gg^Vh, Rr, Aa, Ha, Mm, Mm, Mm, Mm, Mm, Hh, Aa, Aa, Gg, Gg, Gg, Gg, Gg, Gg, Gg, Hh
Gs^Fp, Gs^Fp, Gs^Fp, Gs^Fp, Gg, Gg, Gs^Fp, Gg, Rr, Gg^Vh, Gg, Gg, Aa, Aa, Gg, Gg^Vh, Gg, Gg, Gg, Gg, Ds, Gg, Rr, Rr, Aa, Mm, Mm, Mm, Mm, Mm, Mm, Mm, Ha, Aa, Aa, Gg, Gg, Gg, Gg, Gs^Fp, Hh, Gg
Gs^Fp, Gg, Gg, Gg, Gg, Gg, Gg, Gg, Gg, Rr, Rr, Gg, Aa, Aa, Aa, Aa, Gg, Gg, Gg, Aa, Gg, Rr, Gg, Gg, Ha, Mm, Mm, Mm, Mm, Mm, Mm, Mm, Mm, Aa, Aa, Gg, Gg, Gg, Gg, Gs^Fp, Gg, Gg
Gg, Gg, Gg, Gg, Gg, Aa, Gg, Gg, Gg, Gg, Rr, Gg, Aa, Aa, Aa, Aa, Aa, Gg, Aa, Aa, Gg, Rr, Gg, Gg, Hh, Mm, Ww, Ww, Ww, Mm, Mm, Mm, Mm, Hh, Gg, Gg, Gg, Gg, Gs^Fp, Gs^Fp, Gs^Fp, Gg
Gg, Gg, Gg, Gg, Aa, Aa, Gg, Gg, Gg, Gg, Rr, Gg, Aa, Aa, Aa, Aa, Gg, Gg, Aa, Aa, Gg, Rr, Gg, Gg, Gg, Mm, Ww, Ww^Vm, Ww, Mm, Mm, Mm, Mm, Hh, Gg, Gg, Gs^Fp, Gs^Fp, Gs^Fp, Gg^Ve, Gs^Fp, Gs^Fp
Gg, Gg, Gg, Gg, Aa, Aa, Gg, Gg, Gg, Gg, Rr, Gg, Gg, Aa, Aa, Aa, Gg, Aa, Aa, Gg, Rr, Rr, Gg, Gg, Ww, Ai, Ww, Ww, Ww, Mm, Mm, Mm, Hh, Gg, Gs^Fp, Gs^Fp, Gg, Gg, Gg, Gs^Fp, Gs^Fp, Gs^Fp
Gs^Fp, Gs^Fp, Gg, Gg, Aa, Aa, Gg, Gg, Gg, Gg, Gg, Rr, Gg, Gg, Aa, Aa, Aa, Aa, Aa, Gg, Rr, Gs^Fp, Gs^Fp, Gg, Ha, Ai, Ww, Hh, Ww, Mm, Mm, Hh, Hh, Gg, Gs^Fp, Gg, Gg, Gg, Gg, Gg, Gs^Fp, Gg
Gs^Fp, Gs^Fp, Gg, Gg, Aa, Aa, Aa, Gg, Gg, Gg, Gg^Vh, Rr, Gg, Gg, Aa, Aa, Aa, Aa, Aa, Rr, Hh^Vhh, Hh, Hh, Gg, Aa, Ai, Ww, Hh, Hh, Hh, Gg, Gg, Gg^Vh, Gg, Gs^Fp, Ss, Gg, Gg, Gg, Gg, Gs^Fp, Gs^Fp
Gg, Gg^Ve, Gg, Gg, Aa, Aa, Aa, Aa, Gg, Gg, Gg, Rr, Gg^Vh, Gg, Aa, Aa, Aa, Aa, Aa, Hh, Mm, Mm, Hh, Hh, Aa, Ai, Gg, Gg, Gg, Gs^Fp, Gs^Fp, Gg, Gg, Gg, Gs^Fp, Ss, Gg, Gg, Gg, Gg, Gs^Fp, Gs^Fp
Gs^Fp, Gs^Fp, Gg, Gg, Gg, Aa, Aa, Aa, Gg, Gg, Gg, Rr, Rr, Aa, Aa, Aa, Aa, Rr, Hh, Mm, Mm, Mm, Mm, Hh, Aa, Aa, Aa, Gg, Gg, Gg^Ve, Gs^Fp, Gg, Gg, Gg, Gg, Gs^Fp, Gg, Gg, Gg, Gs^Fp, Gs^Fp, Gs^Fp
Gg, Gg, Gg, Aa, Aa, Aa, Aa, Aa, Aa, Aa, Aa, Aa, Aa, Aa, Aa, Aa, Gg, Rr, Hh, Mm, Mm, Mm, Hh, Hh, Aa, Aa, Aa, Gg, Gg, Gg, Gg, Gg, Gg, Gg, Gg, Gs^Fp, Gs^Fp, Gs^Fp, Gs^Fp, Gs^Fp, Gg, Gs^Fp
Gg, Aa, Aa, Aa, Aa, Aa, Aa, Aa, Aa, Aa, Gg, Aa, Aa, Aa, Aa, Gg, Rr, Rr, Hh, Hh, Hh, Hh, Gg, Gg, Aa, Aa, Aa, Gg, Gg, Gg, Gg, Gg, Gg, Gg, Gg, Gg, Gg, Gg, Gg, Gg, Gg, Gg
Gg, Aa, Aa, Aa, Aa, Aa, Aa, Aa, Aa, Gg, Gg, Rr, Aa, Aa, Gg, Gg, Rr, Gs^Fp, Gs^Fp, Gg^Vh, Gg, Gg, Gg, Gg, Aa, Aa, Aa, Aa, Gg, Gg, Gg, Gg, Gg^Vh, Gg, Gg, Gg, Gg, Aa, Aa, Gg, Aa, Aa
Gg, Gg, Aa, Aa, Aa, Aa, Aa, Aa, Aa, Gg, Rr, Rr, Aa, Aa, Rr, Rr, Gg, Gs^Fp, Gs^Fp, Gg, Gg, Gg, Gg, Gg, Aa, Aa, Aa, Aa, Aa, Aa, Aa, Gg, Gg, Gg, Gg, Gg, Gg, Aa, Aa, Aa, Aa, Aa
Gg, Gg, Ha, Hh, Ha, Ha, Ha, Ha, Aa, Gg, Rr, Gg, Gg, Gg, Rr, Gg, Gg, Gs^Fp, Gg, Gg, Gg, Gg, Gg, Gg, Gg, Aa, Aa, Gg, Aa, Aa, Aa, Gg, Gg, Gg, Gg, Gg, Gg, Gg, Aa, Aa, Aa, Aa
Gg, Aa, Ha, Ha, Ha, Ha, Ha, Ha, Aa, Gg, Rr, Gg^Vh, Rr, Rr, Gg, Gg, Gg, Gg, Gg, Gg, Gg, Gg, Gg, Gg, Gg, Gg, Gg, Gg, Gg, Gg, Gg, Gg, Gg, Gg, Gg, Gg, Gg, Gg, Ds, Ds, Ds, Ds
Gg, Gg, Aa, Aa, Aa, Aa, Aa, Aa, Aa, Aa, Rr, Rr, Gg, Gg, Gg^Vh, Gg, Gg, Gg, Gg, Gg, Gg, Gg, Gg, Gg, Gg, Gg, Gg, Gg, Gg, Gg, Gg, Gg, Gg, Gg, Gg, Gg, Gg, Gg, Ds, Ds, Ds, Gs^Fp
Gg, Aa, Aa, Aa, Aa, Aa, Aa, Aa, Aa, Aa, Rr, Rr, Gs^Fp, Gg, Gg, Gg, Gg, Aa, Gg, Gg, Gg, Gg, Gs^Fp, Gs^Fp, Gs^Fp, Gs^Fp, Gg^Ve, Gg, Gg, Gg, Gg, Gg, Gg, Gg, Gg, Gg, Gg, Gg, Gg, Gs^Fp, Gg^Ve, Gs^Fp
Gg, Aa, Aa, Aa, Aa, Aa, Aa, Aa, Aa, Rr, Gg, Gg, Gg, Gg, Gg, Gg, Aa, Aa, Gg, Gg, Gs^Fp, Gs^Fp, Gg, Gs^Fp, Gs^Fp, Gs^Fp, Gs^Fp, Gs^Fp, Gs^Fp, Gg, Gg, Gg, Gg, Aa, Aa, Aa, Gg, Gg, Gg, Gs^Fp, Ds, Gs^Fp
Ds, Aa, Aa, Aa, Aa, Aa, Gg, Rr, Rr, Gg, Gg, Gg, Gg, Gg, Gg, Gg, Aa, Aa, Gg, Gg, Gs^Fp, Gs^Fp, Gg, Ss, Gs^Fp, Gs^Fp, Gs^Fp, Gg, Gs^Fp, Gs^Fp, Gg, Gg, Gg, Aa, Aa, Aa, Aa, Gg, Gg, Gs^Fp, Gs^Fp, Gs^Fp
Ds, Aa, Aa, Aa, Aa, Aa, Rr, Rr, Rr, Aa, Ha, Ha, Aa, Aa, Aa, Aa, Aa, Aa, Gg, Gg, Gs^Fp, Gs^Fp, Gg, Gs^Fp, Gg^Ve, Gs^Fp, Gs^Fp, Gs^Fp, Gs^Fp, Gs^Fp, Gg^Ve, Gs^Fp, Gg, Gg, Aa, Aa, Aa, Gg, Gg, Gs^Fp, Gs^Fp, Gs^Fp
Gg, Gg, Aa, Aa, Aa, Aa, Rr, Gg^Vh, Rr, Aa, Ha, Ha, Ha, Aa, Aa, Aa, Aa, Aa, Gg, Gs^Fp, Gs^Fp, Gs^Fp, Gg, Gs^Fp, Gs^Fp, Gs^Fp, Gs^Fp, Gs^Fp, Gg^Ve, Gs^Fp, Gs^Fp, Gs^Fp, Gg, Gg, Aa, Aa, Aa, Gg, Gg, Gg, Gg, Gg
Gg, Gg, Gg, Gg, Aa, Aa, Rr, Gg, Rr, Gg, Aa, Aa, Aa, Aa, Aa, Aa, Aa, Aa, Gg, Gg, Gs^Fp, Gs^Fp, Gg, Gg, Gg, Gg, Ss, Ss, Ds, Gs^Fp, Gg, Gg, Gg, Gg, Aa, Aa, Gg, Gg, Gg, Gg, Gg, Gg
Gg, Gg, Gg, Gg, Aa, Aa, Rr, Gg, Rr, Gg, Gg, Aa, Aa, Aa, Aa, Gg^Vh, Aa, Aa, Aa, Gg, Gg, Gg, Gs^Fp, Gg, Gg, Ss, Ss, Ds, Gs^Fp, Gg, Gg, Gg, Gg, Aa, Aa, Aa, Gg, Gg^Vh, Gg, Gg, Gg, Gg
Gg, Gg, Gg^Vh, Gg, Gg, Aa, Ch, Ch, Ch, Gg, Gg, Aa, Aa, Aa, Aa, Aa, Aa, Aa, Gg, Gg, Gg, Gg, Gs^Fp, Gg, Gg, Ss, Ds, Ds, Ds, Gg, Gg, Gg, Aa, Aa, Aa, Aa, Gg, Gg, Gg, Gg, Gg, Gg
Gg, Gg, Aa, Aa, Aa, Aa, Ch, 2 Kh, Ch, Gg, Hh, Gg, Aa, Aa, Aa, Aa, Aa, Gg, Gg, Gg, Gg, Gg, Gs^Fp, Gg, Ss, Ds, Ds, Ds, Ds, Gg, Gg, Aa, Aa, Aa, Aa, Aa, Gg, Gg, Gg, Gg, Gg, Gg
Gg, Gg, Ha, Ha, Ha, Ch, Ch, Ch, Gg, Rr, Hh, Gg, Aa, Aa, Aa, Gg, Gg, Gg, Gg, Gg, Gg, Gg, Gg, Gs^Fp, Gs^Fp, Ds, Ds, Ds, Ds, Aa, Ds, Aa, Aa, Aa, Aa, Aa, Aa, Gg, Gg, Gg, Gg, Aa
Gg, Hh, Ha, Ha, Hh, Hh, Gg, Gg, Gg, Rr, Rr, Gg, Gg, Gg, Gg, Gg, Gg, Gg, Gg^Vh, Gg, Gg, Gg, Gg, Gg, Gg, Ds, Ds, Ds, Ds, Gg, Gg, Gg, Aa, Aa, Aa, Aa, Gg, Gg, Gg, Gg, Gg, Aa
Hh, Hh, Hh, Hh, Hh, Hh, Gg, Gg, Gg, Gg, Gg^Vh, Rr, Gg, Gg, Gg, Gg^Vh, Gg, Gg, Gg, Gg, Gg, Aa, Aa, Gg, Gg, Ds, Ds, Ds, Gg, Gg, Gg^Vh, Gg, Gg, Aa, Gg, Gg, Gg, Hh, Hh, Hh, Hh, Gg
Hh, Hh, Hh, Hh, Gg, Gg, Gg, Gg, Gg, Gg, Gg, Rr, Gg, Gg, Aa, Gg, Gg, Gg, Gg, Gg, Gg, Gg, Gg, Gg, Gg^Vh, Gg, Gg, Ds, Aa, Gg, Gg, Gg, Aa, Gg, Gg, Gg, Hh, Hh, Mm, Hh, Hh, Hh
Hh, Hh, Hh, Hh, Gg, Gg, Gg, Gg, Gg, Gg, Gg, Rr, Aa, Aa, Aa, Gg, Gg, Gg, Gg, Gg, Gg, Gg, Gg, Gg, Gg, Gs^Fp, Gg, Ds, Gg, Gg, Gg, Gg, Gg, Gg, Gg, Hh, Hh, Hh, Mm, Mm, Hh, Hh
