Gg,Gg,Gg,Gg,Gg,Gg,Gg
Gg,Gg,Gg,Gg,Gg,Gg,Gg
Gg,Gg,Gg,Gg,Gg,Gg,Gg
Gg,Gg,Gg,Re,Gg,Gg,Gg
Gg,Gg,Gg,Gg,Gg,Gg,Gg
Gg,Gg,Gg,Gg,Gg,Gg,Gg
Gg,Gg,Gg,Gg,Gg,Gg,Gg
