Gg, Gg, Gg, Gg, Gg, Gg, Gg, Gg, Gg, Gg, Gg
Gg, Gg, Gg, Gg, Gg, Gg, Mm, Gg, Gg, Gg, Gg
Gg, Gg, Gg, Gg, Gg, Mm, Mm, Mm, Mm, Gg, Gg
Gg, Gg, Gg, Gg, Gg, Gg, Gg, Mm, Mm, Mm, Gg
Gg, Gg, Gg, Gg, Gg, Gg, Gg, Gg, Gg, Gg, Gg
Gg, Gg, Gg, Gg, Gg, Gg, Gg, Gg, Gg, Gg, Gg
Gg, Gg, Gg, Gg, Gg, Gg, Gg, Gg, Gg, Gg, Gg