Gg, Gg, Rr, Rr, Gg, Gg, Gg, Gg, Gg, Gg, Gg, Gg, Gg
Gg, Gg, Rr, Rr, Mm, Mm, Mm, Mm, Mm, Mm, Mm, Gg, Gg
Gg, Gg, Rr, Rr, Mm, Mm, Mm, Mm, Mm, Mm, Mm, Gg, Gg
Gg, Gg, Rr, Rr, Mm, Mm, Mm, Mm, Mm, Mm, Mm, Gg, Gg
Gg, Gg, Rr, Rr, Mm, Mm, Mm, Mm, Mm, Mm, Mm, Gg, Gg
Gg, Gg, Rr, Rr, Gg, Gg, Gg, Gg, Gg, Gg, Gg, Gg, Gg
