Gg,Gg,Gg,Gg,Gg,Gg,Gg
Gg,Gg,Gg,Gg,Gg,Gg,Gg
Gg,Gg,Gg,Gg,Gg,Gg,Gg
Gg,Gg,Gg,Gg,Gg,Gg,Gg
Gg,Gg,Gg,Gg,Gg,Gg,Gg
Gg,Gg,Gg,Gg,Gg,Gg,Gg
Gg,Gg,Gg,Gg,Gg,Gg,Gg
