Gg,Gg,Gg,Gg,Gg,Gg,Gg 
Gg,Gg,Gg,Gg,Gg,Gg,Gg 
Gg,Gg,Gg,Gg,Gg,Gg,Gg 
Gg,Gg,Gg,Mm,Gg,Gg,Gg 
Gg,Gg,Gg,Gg,Gg,Gg,Gg 
Gg,Gg,Gg,Gg,Gg,Gg,Gg 
Gg,Gg,Gg,Gg,Gg,Gg,Gg 
