Gg, Gg, Gg, Gg, Gg, Gg, Gg
Gg, Re, Gg, Gg, Gg, Gg, Gg
Gg, Gg, Xue, Gg, Gg, Gg, Gg
Gg, Gg, Xue, Gg, Gg, Gg, Gg
Gg, Gg, Gg, Gg, Gg, Gg, Gg
Gg, Gg, Gg, Gg, Gg, Gg, Gg
Gg, Gg, Gg, Gg, Gg, Gg, Gg
