Gg, Gg, Gg, Re, Gg, Gg, Gg
Gg, Gg, Gg, Re, Gg, Gg, Gg
Gg, Gg, Gg, Re, Gg, Gg, Gg
Gg, Aa^Fpa, Gg, Re, Gg, Gg, Gg
Gg, Aa^Fpa, Gg, Re, Gg, Gg, Gg
Gg, Gg, Gg, Re, Gg, Gg, Gg
Gg, Gg, Gg, Re, Gg, Gg, Gg
